welcome_text1	Website for administrating the CSD3600 module at Middlesex University	Website pour l'administration du module CSD3600 à Middlesex University
footer_generated	This application has been generated using the	Cette application a été générée en utilisant le template d'
footer_eliom_distillery	template for Eliom-distillery and uses the	avec Eliom-distillery et utilise les technologies
footer_technology	 technology.	.
home	{{{capitalize?H||h}}}ome	{{{capitalize?H||h}}}ome
about	{{{capitalize?A||a}}}bout	{{{capitalize?À||à}}} propos
demo	Demo	Démo
password	{{{capitalize?P||p}}}assword	{{{capitalize?M||m}}}ot de passe
retype_password	retype your password	retapez votre mot de passe
your_email	{{{capitalize?Y||y}}}our email	{{{capitalize?V||v}}}otre e-mail
your_password	{{{capitalize?Y||y}}}our password	{{{capitalize?V||v}}}otre mot de passe
your_login	{{{capitalize?Y||y}}}our login	{{{capitalize?V||v}}}otre identifiant
keep_logged_in	keep me logged in	rester connecté
sign_in	{{{capitalize?S||s}}}ign in	{{{capitalize?S||s}}}e connecter
forgot_your_password_q	{{{capitalize?F||f}}}orgot your password?	{{{capitalize?M||m}}}ot de passe oublié ?
sign_up	{{{capitalize?S||s}}}ign up	{{{capitalize?S||s}}}'enregistrer
logout	{{{capitalize?L||l}}}ogout	{{{capitalize?S||s}}}e déconnecter
set_as_main_email	{{{capitalize?S||s}}}et as main email	{{{capitalize?D||d}}}éfinir comme e-mail principal
validated	{{{capitalize?V||v}}}alidated	{{{capitalize?V||v}}}alidé{{{f?e||}}}
waiting_confirmation	{{{capitalize?W||w}}}aiting for confirmation	{{{capitalize?E||e}}}n attente de confirmation
main_email	{{{capitalize?M||m}}}ain email	{{{capitalize?E||e}}}-mail principal
change_password	{{{capitalize?C||c}}}hange your password:	{{{capitalize?C||c}}}hanger votre mot de passe :
link_new_email	Link a new email to your account:	Ajouter une adresse e-mail à votre compte :
currently_registered_emails	Currently registered emails:	E-mails actuellement enregistrés :
settings	{{{capitalize?S||s}}}ettings	{{{capitalize?P||p}}}aramètres
error	{{{capitalize?E||e}}}rror	{{{capitalize?E||e}}}rreur
example_tip	This is an example of tip.	Ceci est un exemple de tip.
look_module_tip	Look at the code to see how it is defined.	Regardez le code pour voir comment c'est défini.
passwords_do_not_match	Passwords do not match	Les mots de passe ne correspondent pas
generate_action_link_key_subject_email	creation	création
sign_up_email_msg	Welcome!\r\nTo confirm your email address, please click on this link:	Bienvenue !\r\nPour confirmer votre adresse e-mail, cliquer sur ce lien :
email_already_exists	Email already exists	Cet e-mail existe déjà
user_does_not_exist	user does not exist	Cet utilisateur n'existe pas
account_not_activated	Account not activated	Ce compte n'est pas activé
wrong_password	Wrong password	Mauvais mot de passe
add_email_msg	Welcome!\r\nTo confirm your email address, please click on this link:	Bienvenue !\r\nPour confirmer votre adresse e-mail, cliquez sur ce lien :
invalid_action_key	Invalid action key, please ask for a new one.	Clef d'action invalide. Demandez en un nouveau svp.
forgot_pwd_email_msg	Hi,\r\nTo set a new password, please click on this link: Bonjour,\r\nPour mettre à jour votre mot de passe, cliquez sur ce lien :
must_be_connected_to_see_page	You must be connected to see this page.	Vous devez être connecté pour voir cette page.
email_address	Email address	Adresse e-mail
your_first_name	Your first name	Votre prénom
your_last_name	Your last name	Votre nom
submit	{{{capitalize?S||s}}}ubmit	{{{capitalize?E||e}}}nvoyer
see_help_again_from_beginning	See help again from beginning	Revoir l'aide depuis le début
personal_information_not_set	Your personal information has not been set yet.	Vous n'avez pas encore entré vos données personnelles.
take_time_enter_name_password	Please take time to enter your name and to set a password.	Veuillez entrer votre nom et choisir un mot de passe svp.
wrong_data_fix	Wrong data. Please fix.	Données incorrectes. Veuillez corriger.
send	{{{capitalize?S||s}}}end	{{{capitalize?E||e}}}nvoyer
recover_password	{{{capitalize?R||r}}}ecover password	{{{capitalize?R||r}}}écupérer le mot de passe.
welcome	{{{capitalize?W||w}}}elcome!	{{{capitalize?B||b}}}ienvenue !
log_in_to_see_page	{{{capitalize?L||l}}}og in to see this page.	{{{capitalize?C||c}}}onnectez-vous pour voir cette page.
you_click_on_date	You clicked on {{y}}/{{m}}/{{d}}	Vous avez cliqué sur {{d}}/{{m}}/{{y}}
you_click_on_time	You clicked on {{h}}:{{m}}	Vous avez cliqué sur {{h}}:{{m}}
change_language	Change language	Changer la langue
change_profile_picture	Change profile picture	Changer votre photo de profil
add_students	{{{capitalize?A||a}}}dd students	{{{capitalize?A||a}}}jouter des étudiants
setup_terms	Setup terms	Réglage des trimestres
write_blog	Write blog	Écrire un blog
setup_sessions	{{{capitalize?S||s}}}etup sessions	{{{capitalize?R||r}}}églage des sessions
changes_to_be_made	Changes to be made	Modifications à faire
action	Action	Action
name	Name	Nom
student_id	Student ID	ID étudiant
joining_week	Joining in week	Rejoint en semaine
term	Term	Trimestre
academic_year	Academic year	Année académique
no_academic_years_yet	No academic years set up yet	Pas encore d'années académiques entrées
no_students_yet	No students entered yet	Pas encore d'étudiants ajoutés
group_number	Group number	Numéro de groupe
csv_file_from_misis	CSV file from MISIS	Fichier CSV depuis MISIS
add_academic_year	Add academic year	Ajouter une année académique
from	From	Depuis
until	Until	Jusqu'à
tbd	TBD	À déterminer
session_type	Session type	Type de session
weekday	Weekday	Jour de semaine
start_time	Start time	Heure de début
end_time	End time	Heure de fin
room	Room	Salle
process	Process	Traiter
no_group	Remove group	Enlever groupe
to_group	To group	En groupe
save	Save	Sauvegarder
register_attendance	Register attendance	Registre de présence
monday	Monday	Lundi
tuesday	Tuesday	Mardi
wednesday	Wednesday	Mercredi
thursday	Thursday	Jeudi
friday	Friday	Vendredi
saturday	Saturday	Samedi
sunday	Sunday	Dimanche
january	January	Janvier
february	February	Février
march	March	Mars
april	April	Avril
may	May	Mai
june	June	Juin
july	July	Juillet
august	August	Août
september	September	Septembre
october	October	Octobre
november	November	Novembre
december	December	Décembre
no_session_now	There is currently no session running.	Il n'y a pas de session actuellement en cours.
unknown_student	This student is not known.	Cet(te) étudiant(e) n'est pas connu(e).
title	Title	Titre
writing_blog_for_week	You are writing your blog for learning week	Vous écrivez votre blog pour la semaine numéro
no_blog_needed	It is not a learning week, you do not need to submit a blog for this week.	Cette semaine n'étant pas une semaine d'éducations, vous n'avez pas à soumettre de blog.
no_blog_for_week	The user has not entered a blog for this week.	L'utilisateur n'a pas soumis de blog pour cette semaine.
no_week_specified	Please specify a week for which you want to see the blog.	Veuillez donner une semaine pour laquelle vous voulez voir le blog.
dashboard	Dashboard	Tableau de bord
current_academic_year	{{{capitalize?C||c}}}urrent academic year	{{{capitalize?A||a}}}nnée académique en cours
learning_week	{{{capitalize?L||l}}}earning week	{{{capitalize?S||s}}}emaine d'éducation
none	{{{capitalize?N||n}}}one	{{{capitalize?A||a}}}ucun
number_of_students	{{{capitalize?N||n}}}umber of enrolled students	{{{capitalize?N||n}}}ombre d'étudiant(e)s inscrit(e)s
your_attendance	Your attendance	Votre présence
your_blogs	Your blogs	Vos blogs
schedule_presentation	Schedule your presentation	Arranger votre présentation
date	Date	Date
first_presenter	First presenter	Premier/ère intervenant(e)
second_presenter	Second presenter	Deuxième intervenant(e)
no_group_number	You have not been assigned a group number.	Vous n'avez pas été affecté(e) à aucun groupe.
invalid_student_id	Invalid student ID	ID étudiant non valide.
unknown_student	This student is not known.	Cet(te) étudiant(e) n'est pas connu(e).
title	Title	Titre
writing_blog_for_week	You are writing your blog for learning week	Vous écrivez votre blog pour la semaine numéro
no_blog_needed	It is not a learning week, you do not need to submit a blog for this week.	Cette semaine n'étant pas une semaine d'éducations, vous n'avez pas à soumettre de blog.
available	{{{capitalize?A||a}}}vailable	{{{capitalize?D||d}}}isponible
not_available	{{{capitalize?N||n}}}ot available	{{{capitalize?N||n}}}on disponible
confirm	{{{capitalize?C||c}}}onfirm	{{{capitalize?C||c}}}onfirmer
cancel	{{{capitalize?C||c}}}ancel	{{{capitalize?A||a}}}nnuler
schedule_message1	This will schedule your presentation on	Vous allez programmer votre présentation le
schedule_message2	Any previously scheduled presentation will be cancelled. Are you sure?	Si vous avez précédemment programmé une présentation, elle sera annulée. Êtes-vous sûr(e)?$
dashboard_message	Here you can see your attendance record (a week marked in red means you did not attend any sessions, orange means you attended some sessions and green means you attended all sessions) and the blogs you have submitted (red means not submitted or not approved, orange means submitted but not yet approved, and green meens submitted and approved). The number in bold at the end is the predicted grade if you keep submitting blogs at the same rate as you have done so far. You can submit blogs and schedule your presentation through the menu on the top left.	Ici vous pouvez consulter le régistre de votre présence (si une semaine est marquée en rouge, vous n'avez pas été présent à aucune session, orange veut dire que vous avez assisté à une partie des sessions, et vert signifie que vous avez assisté a toutes les sessions programmées), ainsi que les blogs que vous avez soumis (rouge pour les blogs non soumis ou non approuvés, orange pour les blogs soumis mais pas encore approuvés, et vert pour les blogs soumis et approuvés). À droite vous pouvez trouver une prédiction de note si vous continuez à soumettre au même rythme). Pour soumettre un blog ou arranger votre présentation, veuillez utiliser le ménu en haut à gauche. 
lecture_on	{{{capitalize?L||l}}}ecture on	{{{capitalize?C||c}}}ours le
seminar_on	{{{capitalize?S||s}}}eminar on	{{{capitalize?T||t}}}ravaux dirigés le
blog_message1	Write your blog about the work you did for the project this week.	Ici vous devez écrire votre blog sur ce que vous avez fait cette semaine pour votre projet.
blog_message2	As an example, it might be good to do this in the style of a SCRUM standup, where you identify the work you did, possible problems you encountered or foresee, and what you plan to do next week.	Vous pourriez le faire dans le style d'une mêlée SCRUM, c'est à dire mentionner ce que vous avez réalisé, les obstacles que vous avez encontrés (ou ce que vous prévoyez), et ce que vous comptez faire la semaine prochaine.
schedule_message	Click on any of the available slots to schedule your presentation.	Cliquez sur un des jours disponibles pour programmer votre présentation.
no_presentation_scheduled	You have not scheduled a presentation.	Vous n'avez pas encore arrangé votre présentation.
your_presentation_is_scheduled_on	Your presentation is scheduled on	Votre présentation est programmée le
attendance	Attendance	Régistre de présence
lecture	{{{capitalize?L||l}}}ecture	{{{capitalize?C||c}}}ours
seminar	{{{capitalize?S||s}}}eminar	{{{capitalize?T||t}}}ravaux dirigés
blogs_to_be_approved	Blogs to be approved	Blogs à approuver
deactivate	Deactivate	Désactiver
deactivated_since	You have left this module in learning week	Vous avez quitté ce cours en semaine numéro
approve	Approve	Approuver
disapprove	Disapprove	Désapprouver
generate_attendance_report	Generate attendance report	Générer compte rendu de présence
start_week	Start week	Semaine de début
end_week	End week	Semaine de fin
generate	Generate	Générer
schedule_for_group	Schedule for group	Programme pour le groupe numéro
view_presentation_schedule	View presentation schedule	Voir programme des présentations
schedule_closed	The schedule is closed.	Le programme est fermé.
unassigned_students	Unassigned students	Étudiants non affectés
submit_report	Submit report	Soumettre un rapport
submit_report_or_draft	Submit report (or draft)	Soumettre un rapport (ou brouillon)
submit_report	Submit report (or draft)	Soumettre rapport (ou brouillon)
draft	Draft	Brouillon
final_version	Final version	Version définitive
quality	Quality	Qualité
independence	Independence	Indépendance
communication	Communication	Communication
text	Text	Texte
evidence	Evidence	Preuves
introduction	Introduction	Introduction
introduction_text	Write your introduction here	Écrivez ici votre introduction
quality_text	Explain here how you meet the quality criterion	Expliquez ici comment vous avez satisfait le critère de qualité
independence_text	Explain here how you meet the independence criterion	Expliquez ici comment vous avez satisfait le critère d'indépendance
communication_text	Explain here how you meet the communication criterion	Expliquez ici comment vous avez satisfait le critère de comminication
yes	Yes	Oui
no	No	Non
final_version_warning1	This will submit your version for eventual assessment.	Vous allez soumettre votre version pour évaluation.
final_version_warning2	You can continue submitting new versions until the deadline; only the latest version you submit will be assessed.	Vous pourrez soumettre des nouvelles versions jusqu'à la date limite; seulement la dernière version que vous avez soumise sera évaluée.
final_version_warning3	Are you sure you want to submit now?	Êtes-vous sûr que vous voulez soumettre maintenant?
give_presentation_feedback	Give presentation feedback	Évaluer une présentation
presentation_feedback	Presentation feedback	Évaluation des présentations
no_presentations_scheduled	There are no presentations scheduled this week.	Il n'y a pas de présentations programmées cette semaine.
nonexistent	Nonexistent	Inexistant
poor	Poor	Médiocre
barely_sufficient	Barely sufficient	À peine acceptable
ok	OK	Satisfaisant
good	Good	Bien
excellent	Excellent	Excellent
comment	Comment	Remarque
no_score_for	No score for {{n}}.	Pas de score pour {{n}}.
no_presenter_selected	No presenter selected	Pas de présentateur sélectionné.
